R 720 480
NO ./textures/xpm/colorstone.xpm
SO ./textures/xpm/eagle.xpm
WE ./textures/xpm/greystone.xpm
EA ./textures/xpm/tnt.xpm

S ./textures/xpm/barrel.xpm
F 220,100,1
C 132,204,242


111111111111111
120000000000021
100000000000201111111111
100000000000000000000001
100000000000201111111101
120000000000021      101
111111111111101      101
        1111101111111101111111111
        1000000000110000000000001
        1011000001110000002000001
        1001000000000000000000001
111111111011000001110000000000001
100000000011000001110111110111111
11110111111111011100000010001
11110111111111011101010010001
11000000110101011100000010001
10002000000000001100000010001
10000000000000001101010010001
1100000111010101111101111000111
1111111111110101011111121000111111111111
120200000000000000000002220000000021   1
1000000000000002000000000000000000011111
1000000100000000000000000000000000001111
10000001000000000000000000000W0000000111
1000000100000000022222222222200000000011
1000000100000000022222222222220000000001
1000000000000000000000000000000000000011
10000000000000000000000000000000000000111
100000000000000000022200000000000001111
1000000000000000000000000000000000011111
100000000000000000000000000000000011   1
1110111121101110110010000111111101121111
1000000000000000000000000000000000000001
1111011111111000000100001111111111002111
10000000000000100000000010000000000111
1111111111111111100000111011112111110111
                100000000000000000000011
                110001111110011111011001
                11001     11000001000101
              111001       1000100010001
   1111111111110001     111 100001111111
   10000000000000111111110111100001
   10112111111001111000200011102001
   10000111112000000010000000001111
   11111   111111111111111111111111
