R 100 100
NO ./textures/xpm/colorstone.xpm
SO ./textures/xpm/eagle.xpm
WE ./textures/xpm/greystone.xpm
EA ./textures/xpm/tnt.xpm

S ./textures/xpm/barrel.xpm
F 220,100,1
C 210,190,255


111111111111111
120000000000021
10000W000000201111111111
100000000000000000000001
100000000000201111111101
120000000000021      101
111111111111101      101
        1111101111111101111111111
        1000000000110000000000001
        1011000001110000002000001
        1001000000000000000000001
111111111011000001110000000000001
100000000011000001110111110111111
11110111111111011100000010001
11110111111111011101010010001
11000000110101011100000010001
10002000000000001100000010001
10000000000000001101010010001
1100000111010101111101111000111
1111111111110101011111121000111111111111
120200000000000000000002220000000021   1
1000000000000002000000000000000000011111
1000000100000000000000000000000000001111
1000000100000000000000000000000000000111
1000000100000000022222222222200000000011
1000000100000000022222222222220000000001
1000000000000000000000000000000000000011
10000000000000000000000000000000000000111
100000000000000000022200000000000001111
1000000000000000000000000000000000011111
100000000000000000000000000000000011   1
1110111121101110110010000111111101121111
1000000000000000000000000000000000000001
1111011111111000000100001111111111002111
10000000000000100000000010000000000111
1111111111111111100000111011112111110111
                100000000000000000000011
                110001111110011111011001
                11001     11000001000101
              111001       1000100010001
   1111111111110001     111 100001111111
   10000000000000111111110111100001
   10112111111001111000200011102001
   10000111112000000010000000001111
   11111   111101111111111111111111
111111111111111011111111111111111111111111111111111111111111111111111111111111111111111111
110000010010000000000010010010010000010010010010010010010000010010010010010000010000010011
1100000000100100100100100000000100100000000000100000000100000000100000000100000100100111
1100100000100000000000000000000000100100100000100000000100000000100000100100000100000111
100010000010010010000010010000010010000010000010010000010000010010000010000000010000010011
11001000000000001000001000000001000000001000000001000001001001000000001001000001111111111
1100000100100100100000100100100100100000100000000100000000000100100100000100000100100111
110000010000000000000000000000000000000010010000010010010000000000000000010000000000010011
110010010000000010010010010010010010010000010000000000010010010010010000010010010000000011
100000000010010010000000000000000000000000010010010010000000000000010000000000010010000011
110010000010000010000010000010010010010010000000000010000010010010010000010000000010000011
100010000010000010010010000010000010000000000000010010000000000010000000010010000010000011
110010000010000000000000010010000010000010010010010000000000010010000000010000000010010011
1100000000100000000100100100000000100100100000000000000100100100000100100100000000000111
1100100000100000100100000000000000000000000000000100100100000000000000000100000100100111
100010000010000010000010010010010010010010000010010000010010000010010010010000010000000011
110010010010000010000000000010000000000010000000000000000010000000000010000000010000000011
110000010000000010010010000010010010000010010010010010000010000010010010000010010000000011
100000010010010000000010010000000010000000000000000010010010000000010000000010000000010011
1100100100000100000000000100100000100100000100100000000000000100100100100100100100100111
110000000000010000000000000010000000010010010000000010000000010000000000000000000000010011
110010010000000010010010000010010010000000010010000010010010010000010010010010000000000011
110000010000000010000010000000000010000010000010010000000000000010010000000010000010010011
1100000100000100100000100100100000100000100000000100100000100100100000000000100000111111
110000010010010000010010000000000010000010000000000010010010000010010000010010000010000011
110000000000000000010000010010010010000010000000000000000000000000010000010000000010010011
110000010000010010010000000000010000000010010010010000010010010000010000010010000000000011
110010010000010000010010000010010000000010000000010010010000010010000000000010010010000011
100010000000010000000000000010000010010010010010000000000000000010010010000010000010000011
110010010000010010000010010010000010000000000000000010010010000000000010000000000010000011
110000010000000010010010000010010010000010010010010010000010010010010010010010010010000011
111111111111111111111111111111111111111111111111111111111111111111111111111111111111111111
