R 720 480
NO ./textures/xpm/colorstone.xpm
SO ./textures/xpm/eagle.xpm
WE ./textures/xpm/greystone.xpm
EA ./textures/xpm/tnt.xpm

S ./textures/xpm/barrel.xpm
F 220,100,1
C 210,190,255

11111
10001
10201
10001
11111
111111111111111111111
100000000000000000001
100000000000000000001
1000000000S0000000001
100000000000000000001
100000000020000000001
100000000000000000001
100000000000000000001
100000000000000000001
100000000000000000001
111111111111111111111
