R 320 200
NO ./textures/coucou.xpm
SO ./textures/wall_concrete.xpm
WE ./textures/wall_wood_1.xpm
EA ./textures/wall_wood_2.xpm

S ./textures/wall.xpm
F 200,100,23
C 100,255,20

1111111111
1000110201
102000S001
10001110011
11111 111111
