R 720 480
NO ./textures/coucou.xpm
SO ./textures/wall_concrete.xpm
WE ./textures/wall_wood_1.xpm
EA ./textures/wall_wood_2.xpm

S ./textures/wall.xpm
F 220,100,0
C 225,30,20

        1111111111111111111111111
        1000000000110000000000001
        1011000001110000002000001
        1001000000000000000000001
111111111011000001110000000000001
100000000011000001110111110111111
11110111111111011100000010001
11110111111111011101010010001
11000000110101011100000010001
10002000000000001100000010001
10000000000000001101010010001
11000001110101011111011110N0111
111111111111010101111112100011111
100200000000000000000000000000001
100000000000000200000000000000001
111111111111111111111111111111111
