R 800 800
NO ./textures/coucou.xpm
SO ./textures/wall_concrete.xpm
WE ./textures/wall_wood_1.xpm
EA ./textures/wall_wood_2.xpm

S ./textures/wall.xpm
F 220,100,0
C 210,190,255

        1111111111111111111111111
        1000000000110000000000001
        1011000001110000002000001
        1001000000000000000000001
111111111011000001110000000000001
100000000011000001110111110111111
11110111111111011100000010001
11110111111111011101010010001
11000000110101011100000010001
10002000000000001100000010001
10000000000000001101010010001
1100000111010101111101111000111
1111111111110101011111121000111111111111
10020000000000000000000000000000001    1
1000000000000002000000000000000000011111
1000000100000000000000000000000000001111
1000000100000000000000000000000000000111
1000000100000000000000000000000000000011
10000001000000000000000000000000000000W1
1000000000000000000000000000000000000011
1000000000000000000000000000000000000111
1000000000000000000000222000000000001111
1000000000000000000000000000000000011111
100000000000000000000000000000000011   1
1111111111111111111111111111111111111111
