R 480 320
NO ./textures/xpm/colorstone.xpm
SO ./textures/xpm/eagle.xpm
WE ./textures/xpm/greystone.xpm
EA ./textures/xpm/tnt.xpm

S ./textures/xpm/barrel.xpm
F 220,100,1
C 210,190,255

11111111111
10000000001
10200000201
10N00000201
10000000001
10000000001
11111111111
        1111111111111111111111111
        1000000000110000000000001
        1011000001110000002000001
        1001000000000000000000001
111111111011000001110000000000001
100000000011000001110111110111111
11110111111111011100000010001
11110111111111011101010010001
11000000110101011100000010001
10002000000000001100000010001
10000000000000001101010010001
1100000111010101111101111000111
1111111111110101011111101000111111111111
120200000000000000000000000000000021   1
1000000000000002000000000000000000011111
1000000100000000000000000000000000001111
1000000100000000000000000000000000000111
1000000100000000022222222222200000000011
1000000100000000022222222222220000000001
1000000000000000000000000000000000000011
10000000000000000000000000000000000000111
100000000000000000022200000000000001111
1000000000000000000000000000000000011111
100000000000000000000000000000000011   1
1110111121101110110010000111111101121111
1000000000000000000000000000000000000001
1111011111111000000100001111111111002111
10000000000000100000000010000000000111
1111111111111111100000111011112111110111
                111111111111111111111111