R 850 550
NO ./textures/xpm/colorstone.xpm
SO ./textures/xpm/colorstone.xpm
WE ./textures/xpm/greystone.xpm
EA ./textures/xpm/mossy.xpm

S ./textures/xpm/monster.xpm
C 40,40,40
F 10,10,10

111111111111111
100000000000001
100200000000001
100200000000001
100200000000001
1000000N0000001
111101111111011
101111111111011111111111111111
120000000000001100200000000001
100000000000001100000100000001
100000000000001100000100020001
100200000000000000000100000001
100000000000001100000000000001
111111111111111111111111111111